Closest Match to Query Sequence - Neogonodactylus_oerstedii|334:
VPOD_ID	Species	Opsin Family	Accession	Î»max
S817	Drosophila_melanogaster	IV	NM_079687.3_K110N	420.0
*** BLAST Metrics ***
Percent_identity: 47.714
Alignment_length: 350
Mismatches: 180
Gap_opens: 2
E_value: 8.97e-125
Alignment:
>Squid
M-------------GRDLR--------DNETWWYNPS---IVVHPHWREFDQVPDAVYYS
LGIFIGICGIIGCGGNGIVIYLFTKTKSLQTPANMFIINLAFSDFTFSLVNGFPLMTISC
FLKKWIFGFAACKVYGFIGGIFGFMSIMTMAMISIDRYNVIGRPMAASKKMSHRRAFIMI
IFVWLWSVLWAIGPIFG-WGAYTLEGVLCNCSFDYISRDSTTRSNILCMFILGFFGPILI
IFFCYFNIVMSVSNHEKEMAAMAKRLNAKELRKA--QAGANAEMRLAKISIVIVSQFLLS
WSPYAVVALLAQFGPLEWVTPYAAQLPVMFAKASAIHNPMIYSVSHPKFREAISQTFPWV
LTCCQFDDKETEDDKDAETEIPAGESSDAAPSADAAQMKEMMAMMQKMQQQQAAYPPQGY
APPPQGYPPQGYPPQGYPPQGYPPQGYPPPPQGAPPQGAPPAAPPQGVDNQAYQA
>Neogonodactylus_oerstedii|334
---------------------------VKMNGWNTPSDYLDYVDSHWLSYEAPNPMLHHL
LGVLYIFLASWSVVGNGLVVFIFLTSKSLRSPSNMLIVNLALADGLQMCKT--PVFIISS
FNEGPVMGRLGCSIYGFIGAYCGPLSACTNAAIAFDRYRTITNPMDG--RLTGSQVMGIL
LFIYAWITPWVWLPFMEIWNRFVPEGFLTSCTFDYMSPN--SKFYVVGLWFCVWFLPMII
ITVCYYNVYCHVAAHEKALKKQAEKMNVESLRSG-DKVNMRQEIRVAKVGITLTTLFLFS
WTPYAAVAFLCTFGRKDLVPPFVSMIPACTSKTSACIDPFVYAINHPKYRLELQKRMPWF
CI----------HEEEPTVETKSTATTDNKPD----------------------------
------------------------------------------------------A
>S817
MESGNVSSSLFGNVSTALRPEARLSAETRLLGWNVPPEELRHIPEHWLTYPEPPESMNYL
LGTLYIFFTLMSMLGNGLVIWVFSAAKSLRTPSNILVINLAFCDFMMMVKN--PIFIYNS
FHQGYALGHLGCQIFGIIGSYTGIAAGATNAFIAYDRFNVITRPMEG--KMTHGKAIAMI
IFIYMYATPWVVACYTETWGRFVPEGYLTSCTFDYLTDNFDTRLFVACIFFFSFVCPTTM
ITYYYSQIVGHVFSHEKALRDQAKKMNVESLRSNVDKNKETAEIRIAKAAITICFLFFCS
WTPYGVMSLIGAFGDKTLLTPGATMIPACACKMVACIDPFVYAISHPRYRMELQKRCPWL
AL----------NEKAPESSAVASTSTTQEPQQTTA------------------------
------------------------------------------------------A

Differences between query and closest match (with squid position):
Position: 1	Query: -	Closest Match: M
Position: N/A	Query: -	Closest Match: E
Position: N/A	Query: -	Closest Match: S
Position: N/A	Query: -	Closest Match: G
Position: N/A	Query: -	Closest Match: N
Position: N/A	Query: -	Closest Match: V
Position: N/A	Query: -	Closest Match: S
Position: N/A	Query: -	Closest Match: S
Position: N/A	Query: -	Closest Match: S
Position: N/A	Query: -	Closest Match: L
Position: N/A	Query: -	Closest Match: F
Position: N/A	Query: -	Closest Match: G
Position: N/A	Query: -	Closest Match: N
Position: N/A	Query: -	Closest Match: V
Position: 2	Query: -	Closest Match: S
Position: 3	Query: -	Closest Match: T
Position: 4	Query: -	Closest Match: A
Position: 5	Query: -	Closest Match: L
Position: 6	Query: -	Closest Match: R
Position: N/A	Query: -	Closest Match: P
Position: N/A	Query: -	Closest Match: E
Position: N/A	Query: -	Closest Match: A
Position: N/A	Query: -	Closest Match: R
Position: N/A	Query: -	Closest Match: L
Position: N/A	Query: -	Closest Match: S
Position: N/A	Query: -	Closest Match: A
Position: N/A	Query: -	Closest Match: E
Position: 7	Query: V	Closest Match: T
Position: 8	Query: K	Closest Match: R
Position: 9	Query: M	Closest Match: L
Position: 10	Query: N	Closest Match: L
Position: 14	Query: T	Closest Match: V
Position: 16	Query: S	Closest Match: P
Position: N/A	Query: D	Closest Match: E
Position: N/A	Query: Y	Closest Match: E
Position: 17	Query: D	Closest Match: R
Position: 18	Query: Y	Closest Match: H
Position: 19	Query: V	Closest Match: I
Position: 20	Query: D	Closest Match: P
Position: 21	Query: S	Closest Match: E
Position: 25	Query: S	Closest Match: T
Position: 27	Query: E	Closest Match: P
Position: 28	Query: A	Closest Match: E
Position: 30	Query: N	Closest Match: P
Position: 31	Query: P	Closest Match: E
Position: 32	Query: M	Closest Match: S
Position: 33	Query: L	Closest Match: M
Position: 34	Query: H	Closest Match: N
Position: 35	Query: H	Closest Match: Y
Position: 39	Query: V	Closest Match: T
Position: 44	Query: L	Closest Match: F
Position: 45	Query: A	Closest Match: T
Position: 46	Query: S	Closest Match: L
Position: 47	Query: W	Closest Match: M
Position: 49	Query: V	Closest Match: M
Position: 50	Query: V	Closest Match: L
Position: 56	Query: V	Closest Match: I
Position: 57	Query: F	Closest Match: W
Position: 58	Query: I	Closest Match: V
Position: 60	Query: L	Closest Match: S
Position: 61	Query: T	Closest Match: A
Position: 62	Query: S	Closest Match: A
Position: 67	Query: S	Closest Match: T
Position: 71	Query: M	Closest Match: I
Position: 73	Query: I	Closest Match: V
Position: 74	Query: V	Closest Match: I
Position: 78	Query: L	Closest Match: F
Position: 79	Query: A	Closest Match: C
Position: 81	Query: G	Closest Match: F
Position: 82	Query: L	Closest Match: M
Position: 83	Query: Q	Closest Match: M
Position: 85	Query: C	Closest Match: V
Position: 87	Query: T	Closest Match: N
Position: 91	Query: V	Closest Match: I
Position: 94	Query: I	Closest Match: Y
Position: 95	Query: S	Closest Match: N
Position: 98	Query: N	Closest Match: H
Position: 99	Query: E	Closest Match: Q
Position: 101	Query: P	Closest Match: Y
Position: 102	Query: V	Closest Match: A
Position: 103	Query: M	Closest Match: L
Position: 105	Query: R	Closest Match: H
Position: 109	Query: S	Closest Match: Q
Position: 111	Query: Y	Closest Match: F
Position: 113	Query: F	Closest Match: I
Position: 116	Query: A	Closest Match: S
Position: 118	Query: C	Closest Match: T
Position: 120	Query: P	Closest Match: I
Position: 121	Query: L	Closest Match: A
Position: 122	Query: S	Closest Match: A
Position: 123	Query: A	Closest Match: G
Position: 124	Query: C	Closest Match: A
Position: 128	Query: A	Closest Match: F
Position: 131	Query: F	Closest Match: Y
Position: 134	Query: Y	Closest Match: F
Position: 135	Query: R	Closest Match: N
Position: 136	Query: T	Closest Match: V
Position: 139	Query: N	Closest Match: R
Position: 142	Query: D	Closest Match: E
Position: 146	Query: R	Closest Match: K
Position: 147	Query: L	Closest Match: M
Position: 149	Query: G	Closest Match: H
Position: 150	Query: S	Closest Match: G
Position: 151	Query: Q	Closest Match: K
Position: 152	Query: V	Closest Match: A
Position: 153	Query: M	Closest Match: I
Position: 154	Query: G	Closest Match: A
Position: 155	Query: I	Closest Match: M
Position: 156	Query: L	Closest Match: I
Position: 157	Query: L	Closest Match: I
Position: 161	Query: A	Closest Match: M
Position: 162	Query: W	Closest Match: Y
Position: 163	Query: I	Closest Match: A
Position: 168	Query: W	Closest Match: V
Position: 169	Query: L	Closest Match: A
Position: 170	Query: P	Closest Match: C
Position: 171	Query: F	Closest Match: Y
Position: 172	Query: M	Closest Match: T
Position: N/A	Query: I	Closest Match: T
Position: 175	Query: N	Closest Match: G
Position: 182	Query: F	Closest Match: Y
Position: 191	Query: M	Closest Match: L
Position: 192	Query: S	Closest Match: T
Position: 193	Query: P	Closest Match: D
Position: 195	Query: -	Closest Match: F
Position: 196	Query: -	Closest Match: D
Position: 197	Query: S	Closest Match: T
Position: 198	Query: K	Closest Match: R
Position: 199	Query: F	Closest Match: L
Position: 200	Query: Y	Closest Match: F
Position: 202	Query: V	Closest Match: A
Position: 203	Query: G	Closest Match: C
Position: 204	Query: L	Closest Match: I
Position: 205	Query: W	Closest Match: F
Position: 207	Query: C	Closest Match: F
Position: 208	Query: V	Closest Match: S
Position: 209	Query: W	Closest Match: F
Position: 210	Query: F	Closest Match: V
Position: 211	Query: L	Closest Match: C
Position: 213	Query: M	Closest Match: T
Position: 214	Query: I	Closest Match: T
Position: 215	Query: I	Closest Match: M
Position: 218	Query: V	Closest Match: Y
Position: 219	Query: C	Closest Match: Y
Position: 221	Query: Y	Closest Match: S
Position: 222	Query: N	Closest Match: Q
Position: 223	Query: V	Closest Match: I
Position: 224	Query: Y	Closest Match: V
Position: 225	Query: C	Closest Match: G
Position: 228	Query: A	Closest Match: F
Position: 229	Query: A	Closest Match: S
Position: 235	Query: K	Closest Match: R
Position: 236	Query: K	Closest Match: D
Position: 239	Query: E	Closest Match: K
Position: 249	Query: G	Closest Match: N
Position: N/A	Query: -	Closest Match: V
Position: 251	Query: V	Closest Match: N
Position: 252	Query: N	Closest Match: K
Position: 253	Query: M	Closest Match: E
Position: 254	Query: R	Closest Match: T
Position: 255	Query: Q	Closest Match: A
Position: 259	Query: V	Closest Match: I
Position: 262	Query: V	Closest Match: A
Position: 263	Query: G	Closest Match: A
Position: 266	Query: L	Closest Match: I
Position: 267	Query: T	Closest Match: C
Position: 268	Query: T	Closest Match: F
Position: 271	Query: L	Closest Match: F
Position: 272	Query: F	Closest Match: C
Position: 278	Query: A	Closest Match: G
Position: 279	Query: A	Closest Match: V
Position: 280	Query: V	Closest Match: M
Position: 281	Query: A	Closest Match: S
Position: 282	Query: F	Closest Match: L
Position: 283	Query: L	Closest Match: I
Position: 284	Query: C	Closest Match: G
Position: 285	Query: T	Closest Match: A
Position: 288	Query: R	Closest Match: D
Position: 290	Query: D	Closest Match: T
Position: 292	Query: V	Closest Match: L
Position: 293	Query: P	Closest Match: T
Position: 295	Query: F	Closest Match: G
Position: 296	Query: V	Closest Match: A
Position: 297	Query: S	Closest Match: T
Position: 303	Query: T	Closest Match: A
Position: 304	Query: S	Closest Match: C
Position: 306	Query: T	Closest Match: M
Position: 307	Query: S	Closest Match: V
Position: 318	Query: N	Closest Match: S
Position: 321	Query: K	Closest Match: R
Position: 324	Query: L	Closest Match: M
Position: 330	Query: M	Closest Match: C
Position: 333	Query: F	Closest Match: L
Position: 334	Query: C	Closest Match: A
Position: 335	Query: I	Closest Match: L
Position: 346	Query: H	Closest Match: N
Position: 348	Query: E	Closest Match: K
Position: 349	Query: E	Closest Match: A
Position: 351	Query: T	Closest Match: E
Position: 352	Query: V	Closest Match: S
Position: 353	Query: E	Closest Match: S
Position: 354	Query: T	Closest Match: A
Position: 355	Query: K	Closest Match: V
Position: 356	Query: S	Closest Match: A
Position: 357	Query: T	Closest Match: S
Position: 358	Query: A	Closest Match: T
Position: 359	Query: T	Closest Match: S
Position: 361	Query: D	Closest Match: T
Position: 362	Query: N	Closest Match: Q
Position: 363	Query: K	Closest Match: E
Position: 365	Query: D	Closest Match: Q
Position: 366	Query: -	Closest Match: Q
Position: 367	Query: -	Closest Match: T
Position: 368	Query: -	Closest Match: T
Position: 369	Query: -	Closest Match: A

